11111
1E0P1
11C01
10101
11111
