NO ./sprites/north.xpm
SO ./sprites/south.xpm
WE ./sprites/west.xpm
EA ./sprites/east.xpm



F 220,100,0
C 225,30,0


1111111111111111111111111
1000000000110000000000001
101100000111000000000000
10010000000000000N0000001
1111111111111111111111111
