11111111
11E00001
11000001
11000001
10010P01
10000001
11C00001
11111111