11111111
11000001
11000001
11000001
10010P01
10000001
11000001
11111111