11111111
110E0001
10010P01
1C000001
11111111