11111111
11E00001
11000001
11000001
10010001
10011111
11C000P1
11111111