11111111
11000001
11000001
11000001
10010P01
1C000001
11000001
11111111