11111111
11E000B1
11000001
11000001
10010001
10000001
11C000P1
11111111