11111111111111111111111111
1000B000000000000000000001
10B0B000000000000000000001
10B0B000000000000000000001
10B0B000000000000000000001
1CB0B000000000000000000001
1BB0B000000000000000000001
10000BBB000000000000000001
10BB0000B00000000000000001
10BBBBB0B00000000000000001
10BB0000B0000000000B000001
10BB0BBBB00000000000000001
1PBB00000000000000000000E1
11111111111111111111111111