11111111
11E00001
100P0001
11C00001
11111111