11111
1E1P1
10101
1C001
11111
